000000000000000000000000
000000111100000000000000
000110000000000000011110
000000000001000001000000
000001000000011100000000
000000000000000000000000
000000111000000000000000
000000000000000000000000
000111000000000000000000
000000000000000000000000